1 13 31
###############################
#p   s   * 1*     **    * *   #
#x#*# #######*#*### # #*#*#*# #
#f  *     *   *    *  *   * * #
# * # # # #*# # # #*###*# # #*#
#  #    *    **  *  *         #
# # # # # ### #*# #*# # # # # #
#   *      *  *      *  *     #
# # # # #*# ### #*#*### # # # #
#*    **  *       *           #
# #*# # #*# # # #*# # # # # # #
#       #   *   *  *          #
###############################

