1 13 31
###############################
#p   s      *2    **    * *   #
# #*# #*# ###*#*### # #*#*#*# #
#f  *     *   *    * 1*   * * #
# * # # # #*# # # #*###*# #2#*#
#  #    *    **  *  *         #
# # # # # ### #*# #*# # # # # #
#   *      *  *1     *  *     #
# # # # #*# ### #*#*### # # # #
#*    **  *       *2          #
# #*# # #*# # # #*# # # # # # #
#       # 1 *   *  *          #
###############################
