1 13 31
###############################
#p    s  *  ##    *   1*  #   #
# # #    #   # *   ## #       #
#  #  #   #    #     *   ##* *#
# #    # f  #    #      #   # #
#    #* *      ##  *   *   2  #
# # #   #  #*       #   ##   ##
#   *  # *#  #   #  F #   # * #
# #   #  #  *  #    #      #  #
#*  #     *1 #    #   #       #
# #*# # #*# # #  #  #* # # *  #
#       #   *  #   *   1*    x#
###############################
