1 13 31
###############################
#p     * 1####  ####     x    #
#     ####  ####              #
#x         #   #              #
#       #  #    #             #
#f         #   #         x    #
#           ###               #
#*  *      *  *               #
#                             #
#*                            #
#                             #
#               *  *          #
###############################