1 13 31
###############################
#p        ####  ####     x    #
#           ####              #
#  x       #   #              #
#       #  # 1  #             #
#f         #   #         x    #
#           ###               #
#*  *      *  *               #
#                             #
#*                            #
#                             #
#               *  *          #
###############################